make sb out | I just can't make Jim out at all (understand).|english-phrasal-verbs english-phrasal-verbs-01
look sb up | I'll look you up next time I'm in Shanghai (visit).|english-phrasal-verbs english-phrasal-verbs-01
be looking up | Things are looking up (improve).|english-phrasal-verbs english-phrasal-verbs-01
eat out | I was too tired to cook at home so I decided to eat out.|english-phrasal-verbs english-phrasal-verbs-01
bring back | This photograph brings back happy memories.|english-phrasal-verbs english-phrasal-verbs-01
ring sb back | I'll ring you back later.|english-phrasal-verbs english-phrasal-verbs-01
drop off sb/sth | I dropped off the package at her house.|english-phrasal-verbs english-phrasal-verbs-01
send off sth; turn up | I sent off the order last week but the goods haven't turned up yet.|english-phrasal-verbs english-phrasal-verbs-01
come across sth; take down sth | I came across an interesting book in the library. I took down the title.|english-phrasal-verbs english-phrasal-verbs-01
ask sb around; play up; break down | We asked some friends around to watch a film, but the video was playing up and it eventually broke down.|english-phrasal-verbs english-phrasal-verbs-01
bring up sth; sort out sth | I brought up this problem at the last meeting. It's really time to sort out the problem.|english-phrasal-verbs english-phrasal-verbs-01
mess sb about; put sth off; call sth off | I wish he'd stop messing us about! He's put the meeting off three times and now he wants to call it off altogether.|english-phrasal-verbs english-phrasal-verbs-01
look down on sb/sth | She seems to look down on people who are less intelligent than her.|english-phrasal-verbs english-phrasal-verbs-01
do away with sth | The school decided to do away with the language lab as no-one was using it.|english-phrasal-verbs english-phrasal-verbs-01
come up against sth | I came up against a serious problem when I tried to save my work onto a disk.|english-phrasal-verbs english-phrasal-verbs-01
get away with sth/doing sth | How can some students get away with doing no work and yet pass the exams?|english-phrasal-verbs english-phrasal-verbs-01
put up with sb | Her son is so horrible. I don't know how she puts up with him.|english-phrasal-verbs english-phrasal-verbs-01
give sth in | I gave my essay in yesterday.|english-phrasal-verbs english-phrasal-verbs-02
get on sth | She got on the bus.|english-phrasal-verbs english-phrasal-verbs-02
get on | Jim and Mary don't get on.|english-phrasal-verbs english-phrasal-verbs-02
come round | Would you like to come round this evening? He was unconscious for three hours but came round in hospital.|english-phrasal-verbs english-phrasal-verbs-02
put off sth | Let's put off the meeting until Friday.|english-phrasal-verbs english-phrasal-verbs-02
get over sth | It took him a long time to get over his illness.|english-phrasal-verbs english-phrasal-verbs-02
cut out | About five miles into our journey the engine cut out and we broke down completely.|english-phrasal-verbs english-phrasal-verbs-02
dress up | Do we need to dress up tonight or is it informal?|english-phrasal-verbs english-phrasal-verbs-02
go through sth | I shall never really appreciate what my grandparents went though during the war.|english-phrasal-verbs english-phrasal-verbs-02
brush aside sth | They just brushed aside my complaints; it made me very angry.|english-phrasal-verbs english-phrasal-verbs-02
fall for sth | I fell for his story about having lost all his money. How stupid I was!|english-phrasal-verbs english-phrasal-verbs-02
chase sth up | Could you chase Janet's report up? She promised it last week but I haven't seen it yet.|english-phrasal-verbs english-phrasal-verbs-02
leave out sth | If you are phoning from outside the country, leave out the first zero in the city code.|english-phrasal-verbs english-phrasal-verbs-02
put out sth | The government have put out a statement condemning the recent protests.|english-phrasal-verbs english-phrasal-verbs-02
see to sth | Could you see to lunch for our visitors? There will be four of them.|english-phrasal-verbs english-phrasal-verbs-02
think sth over | Think it over before you make up your mind what to do next.|english-phrasal-verbs english-phrasal-verbs-03
turn over sth | You may turn over the page now and read the exam questions.|english-phrasal-verbs english-phrasal-verbs-03
pull over | It's raining too hard to drive. Pull over to the edge of the road.|english-phrasal-verbs english-phrasal-verbs-03
look over sth | Look over the answers before the end of the exam.|english-phrasal-verbs english-phrasal-verbs-03
have sth on | I have a lot of work on today (never in continuous tenses)|english-phrasal-verbs english-phrasal-verbs-03
have sth on; have on sth | John has an amazing tie on.|english-phrasal-verbs english-phrasal-verbs-03
have sb on | I don't believe you! I'm sure you're having me on.|english-phrasal-verbs english-phrasal-verbs-03
move over | Can you move over to make room for your sister?|english-phrasal-verbs english-phrasal-verbs-03
read sth over | When Jill finished her essay, she asked Harry to read it over.|english-phrasal-verbs english-phrasal-verbs-03
invite sb back | Jim has invited me back to his house tomorrow.|english-phrasal-verbs english-phrasal-verbs-03
be ripped off; rip-off | I got ripped off when I phoned that 800 number. Yes, those numbers are a big rip-off.|english-phrasal-verbs english-phrasal-verbs-04
drop out; dropout | He dropped out of college last year. Mm, there were a lot of dropouts that year.|english-phrasal-verbs english-phrasal-verbs-04
break in; break-in | Someone broke in last night and that's the second break-in this year!|english-phrasal-verbs english-phrasal-verbs-04
outset | I knew from the outset that there would be problems. (beginning, see also set out)|english-phrasal-verbs english-phrasal-verbs-04
downfall | The economic crisis caused the downfall of the government.|english-phrasal-verbs english-phrasal-verbs-04
onlooker/bystander | Crowds of onlookers/bystanders watched as the police arrested the man.|english-phrasal-verbs english-phrasal-verbs-04
pile-up | There was a big pile-up on the motorway involving five vehicles.|english-phrasal-verbs english-phrasal-verbs-04
cutback | The company has announced a series of cutbacks in order to save money.|english-phrasal-verbs english-phrasal-verbs-04
outcry | When the higher taxes were announced there was a public outcry.|english-phrasal-verbs english-phrasal-verbs-04
breakthrough | The new drug marks a breakthrough in the treatment of this illness.|english-phrasal-verbs english-phrasal-verbs-04
getaway | The robbers abandoned their getaway car.|english-phrasal-verbs english-phrasal-verbs-04
off-putting | I find his manner very off-putting. He's so unfriendly.|english-phrasal-verbs english-phrasal-verbs-04
throwaway | They decided to use throwaway paper plates and cups for their party.|english-phrasal-verbs english-phrasal-verbs-04
outgoing | Let's invite Sally - she's very outgoing and loves parties.|english-phrasal-verbs english-phrasal-verbs-04
bygone | It was like something from a bygone era.|english-phrasal-verbs english-phrasal-verbs-04
going-on | Have you heard about the scandal in the office? Mm, amazing goings-on.|english-phrasal-verbs english-phrasal-verbs-04
downturn | The economy is not doing so well these days. Yes, there's been a downturn. (see also upturn)|english-phrasal-verbs english-phrasal-verbs-04
get on with sth | I'm trying to get on with my work.|english-phrasal-verbs english-phrasal-verbs-05
blow up | blow up a balloon -> blow up a building -> someone blows up|english-phrasal-verbs english-phrasal-verbs-05
slip up | These statistics look strange. Have you slipped up somewhere?|english-phrasal-verbs english-phrasal-verbs-05
take sb in (stay) | Because so many passengers were stranded at the airport, some local families offered to take them in overnight.|english-phrasal-verbs english-phrasal-verbs-05
take sth in (understand) | The news is so shocking - I still can't take it in.|english-phrasal-verbs english-phrasal-verbs-05
take in sth (include) | The excursion will take in two of the most beautiful castles in the region.|english-phrasal-verbs english-phrasal-verbs-05
take in sth (reduce) | Marie has lost weight - she's going to have to take in a lot of her clothes.|english-phrasal-verbs english-phrasal-verbs-05
be taken in (deceive) | Rob was totally dishonest but he was so charming that I was taken in by him.|english-phrasal-verbs english-phrasal-verbs-05
(boat) take in sth | We'd better return to the shore at once - the boat seems to be taking in water.|english-phrasal-verbs english-phrasal-verbs-05
step in | She stepped in to stop the argument from becoming more serious.|english-phrasal-verbs english-phrasal-verbs-05
tie down | Mark dreams of travelling but he feels tied down by his family and work responsibilities.|english-phrasal-verbs english-phrasal-verbs-05
drive at | What are you driving at? I wish you would say exactly what you mean!|english-phrasal-verbs english-phrasal-verbs-05
drum sth into | The teach did all she could to drum the vocabulary into her pupils before the exam.|english-phrasal-verbs english-phrasal-verbs-05
cream off sth | The education system used to cream off the best pupils and teach them in separate schools.|english-phrasal-verbs english-phrasal-verbs-05
drown out | The noise of the children's music completely drowned out the television.|english-phrasal-verbs english-phrasal-verbs-05
let up | As the rain didn't let up, the football game was called off.|english-phrasal-verbs english-phrasal-verbs-05
get down to sth | The team got down to discussing its strategy for the next match.|english-phrasal-verbs english-phrasal-verbs-05
The government is going to release a report on traffic congestion. I wonder when it's coming _ | out|english-phrasal-verbs english-phrasal-verbs-06
I thought you were coming to the dinner party last night. Yes, I was intending to, but right at the last minute something _ | came up|english-phrasal-verbs english-phrasal-verbs-06
Suddenly the lights went _ | off|english-phrasal-verbs english-phrasal-verbs-08
A bad cough and a sore throat often go _ | together|english-phrasal-verbs english-phrasal-verbs-08
I wasn't in the demonstration. I was just an _ | onlooker|english-phrasal-verbs english-phrasal-verbs-09
After a long recession the economic situation is looking _ | up|english-phrasal-verbs english-phrasal-verbs-09
Jack is behaving very strangely at the moment. I just can't make him _ | out|english-phrasal-verbs english-phrasal-verbs-10
That light is too strong. Shall we put it _ | out|english-phrasal-verbs english-phrasal-verbs-11
Joe is very good at putting his ideas _ | across|english-phrasal-verbs english-phrasal-verbs-11
I shouldn't have called you lazy - I take it _ | back|english-phrasal-verbs english-phrasal-verbs-12
He showed me a photo of his house, but I was so tired that I didn't really take it _ | in|english-phrasal-verbs english-phrasal-verbs-12
_ up your vegetables, children | Eat|english-phrasal-verbs english-phrasal-verbs-13
_ up your juice | Drink|english-phrasal-verbs english-phrasal-verbs-13
_ the cream in gently with the tips of your fingers | rub|english-phrasal-verbs english-phrasal-verbs-16
